Kaldríss
An Interactive Fiction by Daniel
Release 1 / Serial number 170709 / Inform 7 build 6M62 (I6/v6.33 lib 6/12N) SD

Spaceship Bridge
The place where all the magic happens. Well, it used to be at least - during the impact most of the important equpiment including the communication systems must have been fried and doesn't seem to work anymore.  There's only a single flickering light inside the command panel. What could this mean? I should probably open the command panel and take a look. I could also go south and check the storage of the spaceship first.

>i
You are carrying:
  a suit capacitor (being worn)

>open command panel
You open the command panel, revealing a protector glove, a fried communicator, a power unit, a green button and an encryption key.

>take all
protector glove: Taken.
encryption key: Taken.

>insert glove into suit capacitor
No.

The suit capacitor is only meant to only pure energy and nothing else. Inserting anything else destroys it. You discard its ruined remains, looking miserably down at the protector glove on the floor.

* * *

>take all
protector glove: Taken.
encryption key: Taken.

>insert glove into capacitor
You put the protector glove into the suit capacitor.

>yes
That was a rhetorical question.

>insert glove into capacitor
(first taking the protector glove)
You put the protector glove into the suit capacitor.

>s
Spaceship Storage
Taking a quick look inside the storage room doesn't seem to reveal anything particularly interesting. There are only some random souvenirs from your previous intergalactic travels and your locker which you haven't opened in ages.  It also looks like the airlock in the south doesn't seem to function anymore so perhaps I should go check that out as well?

>n
You got caught in a meteor shower and while trying your best to manouver your spaceship through it  your engine still took a hit. You then had to crash-land on Kaldríss - one of the most cold planets in this solar system.  Since only a few explorers made their to this planet there's not a whole lot of information available about this icy place. You are pretty much on your own now. The spaceship also won't take off before it hasn't been properly repaired. But first things first. Without any kind of heat you won't survive this bleakness for long. You tame a look at the command panel in hopes of finding something of use but it doesn't look very good. There's only a single green button on the command panel. What could this mean? I might also wanna  take a look at the spaceship exit that lies straight ahead since it seems to be busted, too.

>look
Spaceship Bridge
The place where all the magic happens. Well, it used to be at least - during the impact most of the important equpiment including the communication systems must have been fried and doesn't seem to work anymore.  There's only a single flickering light inside the command panel. What could this mean? I should probably open the command panel and take a look. I could also go south and check the storage of the spaceship first.

>x
What do you want to examine?

>spaceship storage
You can't see any such thing.

>x spacesuit
You can't see any such thing.

>s
Spaceship Storage
Taking a quick look inside the storage room doesn't seem to reveal anything particularly interesting. There are only some random souvenirs from your previous intergalactic travels and your locker which you haven't opened in ages.  It also looks like the airlock in the south doesn't seem to function anymore so perhaps I should go check that out as well?

>x locker
Now I remember! I used to store things in here that could come in very hand in emergencies! Let's see if I can find something useful in here.

* * *

Kaldríss
An Interactive Fiction by Daniel
Release 1 / Serial number 170709 / Inform 7 build 6M62 (I6/v6.33 lib 6/12N) SD

Spaceship Bridge
The place where all the magic happens. Well, it used to be at least - during the impact most of the important equpiment including the communication systems must have been fried and doesn't seem to work anymore.  There's only a single flickering light inside the command panel. What could this mean? I should probably open the command panel and take a look. I could also go south and check the storage of the spaceship first.

>open command panel
You open the command panel, revealing a protector glove, a fried communicator, a power unit, a green button and an encryption key.

* * *

>take all
protector glove: Taken.
encryption key: Taken.

>s
Spaceship Storage
Taking a quick look inside the storage room doesn't seem to reveal anything particularly interesting. There are only some random souvenirs from your previous intergalactic travels and your locker which you haven't opened in ages.  It also looks like the airlock in the south doesn't seem to function anymore so perhaps I should go check that out as well?

>unlock locker
What do you want to unlock the locker with?

>encryption key
This key seems to fit.  Lock mechanism status: DEACTIVATED // You may proceed to open the locker.

>open locker
You open the locker, revealing an emergency torch and a spacesuit.

>take spacesuit
Taken.

>i
You are carrying:
  a spacesuit
  a protector glove

>put on spacesuit
You put on the spacesuit.

>i
You are carrying:
  a spacesuit (being worn)
  a protector glove

>insert glove into energy capacitor
This glove will surely not fit into the capacitor so it's not advised to continue this action. Otherwise the energy capacitor might break

>insert glove into energy capacitor
You put the protector glove into the energy capacitor.

>drop glove
You haven't got that.

>remove glove from capacitor
Taken.

>s
Spaceship Exit
The airlock also seems to be affected by the crash and the temperatures inside the spaceship are nearing dangerous levels. I could leave the spaceship right now by going east but I if I don't have something to protect me from the cold I will probably die.

>s
You don't want to go there.

>sn
That's not a verb I recognise.

>s
You don't want to go there.

>look
Spaceship Exit
The airlock also seems to be affected by the crash and the temperatures inside the spaceship are nearing dangerous levels. I could leave the spaceship right now by going east but I if I don't have something to protect me from the cold I will probably die.

>w
You don't want to go there.

>e
You can't leave the spaceship just yet. You need to find something to keep you warm before you venture off!

>s
You don't want to go there.

>n
Spaceship Storage
Taking a quick look inside the storage room doesn't seem to reveal anything particularly interesting. There are only some random souvenirs from your previous intergalactic travels and your locker which you haven't opened in ages.  It also looks like the airlock in the south doesn't seem to function anymore so perhaps I should go check that out as well?

>n
You got caught in a meteor shower and while trying your best to manouver your spaceship through it  your engine still took a hit. You then had to crash-land on Kaldríss - one of the most cold planets in this solar system.  Since only a few explorers made their to this planet there's not a whole lot of information available about this icy place. You are pretty much on your own now. The spaceship also won't take off before it hasn't been properly repaired. But first things first. Without any kind of heat you won't survive this bleakness for long. You tame a look at the command panel in hopes of finding something of use but it doesn't look very good. There's only a single green button on the command panel. What could this mean? I might also wanna  take a look at the spaceship exit that lies straight ahead since it seems to be busted, too.

I beg your pardon?

>look
Spaceship Bridge
The place where all the magic happens. Well, it used to be at least - during the impact most of the important equpiment including the communication systems must have been fried and doesn't seem to work anymore.  There's only a single flickering light inside the command panel. What could this mean? I should probably open the command panel and take a look. I could also go south and check the storage of the spaceship first.

>open command panel
That's already open.

>push button
Beep Boop! Power Unit status: UNLOCKED.

Caution advised.

>open power unit
You open the power unit, revealing a pure flux essence.

>take essence
I totally forgot that I've put this here. This orb holds a huge amount of energy which could be used to power all kinds of devices and possibly even my suit capacitor.

I really shouldn't be touching the pure flux essence without something that protects my hand. This orb is made out of pure energy and would therefore disintegrate my hand if I touch it without any protection.

>take essence
I totally forgot that I've put this here. This orb holds a huge amount of energy which could be used to power all kinds of devices and possibly even my suit capacitor.

I really shouldn't be touching the pure flux essence without something that protects my hand. This orb is made out of pure energy and would therefore disintegrate my hand if I touch it without any protection.

>put on glove
You put on the protector glove.

>take essence
I totally forgot that I've put this here. This orb holds a huge amount of energy which could be used to power all kinds of devices and possibly even my suit capacitor.

This could really work!

Taken.

>s
Spaceship Storage
Taking a quick look inside the storage room doesn't seem to reveal anything particularly interesting. There are only some random souvenirs from your previous intergalactic travels and your locker which you haven't opened in ages.  It also looks like the airlock in the south doesn't seem to function anymore so perhaps I should go check that out as well?

>s
Spaceship Exit
The airlock also seems to be affected by the crash and the temperatures inside the spaceship are nearing dangerous levels. I could leave the spaceship right now by going east but I if I don't have something to protect me from the cold I will probably die.

>e
You can't leave the spaceship just yet. You need to find something to keep you warm before you venture off!

>insert essence into spacesuit
That can't contain things.

>insert essence into capacitor
Do I really wanna do this? Chances of me dying are quite high. On the other hand, I will probably die anyway if I don't try.

>e
Now that you found a way to stay warm you should be able to leave the spaceship without instantly freezing to death.

Crash Zone
The surface of Kaldríss consists of spiky ice formations as far as the eye can see . No wonder nobody in his right mind would try to land here willingly. There doesn't seem to be anything of interest wherever you look. After taking a closer look you suddenly notice some sort of structure north of your position. If you hurry up you should be able to make it there before you freeze.

>e
You don't want to go there.

I beg your pardon?

>e
You don't want to go there.

* * *

>s
Spaceship Storage
Taking a quick look inside the storage room doesn't seem to reveal anything particularly interesting. There are only some random souvenirs from your previous intergalactic travels and your locker which you haven't opened in ages.  It also looks like the airlock in the south doesn't seem to function anymore so perhaps I should go check that out as well?

>unlock locker with key
This key seems to fit.  Lock mechanism status: DEACTIVATED // You may proceed to open the locker.

>open locker
You open the locker, revealing an emergency torch and a spacesuit.

>x spacesuit
Spacesuit Mk. XV

Made for deep space travel due to its extraordinary thermodynamic capabilities.

This model also has an energy capacitor built in that needs some kind of energy in order to properly work. The more pure the energy the more effective the suits thermal protection will work.

After taking a closer look it seems like the suit doesn't have any juice left so you would still freeze pretty quickly after leaving the spaceship. Unless, of course, you find some kind of energy source that fits right in.

>take spacesuit
Taken.

>s
Spaceship Exit
The airlock also seems to be affected by the crash and the temperatures inside the spaceship are nearing dangerous levels. I could leave the spaceship right now by going east but I if I don't have something to protect me from the cold I will probably die.

>w
You don't want to go there.

>n
Spaceship Storage
Taking a quick look inside the storage room doesn't seem to reveal anything particularly interesting. There are only some random souvenirs from your previous intergalactic travels and your locker which you haven't opened in ages.  It also looks like the airlock in the south doesn't seem to function anymore so perhaps I should go check that out as well?

>n
Spaceship Bridge
The place where all the magic happens. Well, it used to be at least - during the impact most of the important equpiment including the communication systems must have been fried and doesn't seem to work anymore.  There's only a single flickering light inside the command panel. What could this mean? I should probably open the command panel and take a look. I could also go south and check the storage of the spaceship first.

>push button
Beep Boop! Power Unit status: UNLOCKED.

Caution advised.

>open power unit_Kaldríss
You open the power unit, revealing a pure flux essence.

>take essence
This flux essence used to contain way more energy since it's been in use for quite a while but it's possible that it still contains enough energy to power your spacesuit.

You really shouldn't be touching the pure flux essence without something that protects you from its enormous amounts of energy. This flux essence consists of pure energy and would therefore immediately disintegrate your hand if you touched it without a glove.

>put on glove
You put on the protector glove.

>take essence
This flux essence used to contain way more energy since it's been in use for quite a while but it's possible that it still contains enough energy to power your spacesuit.

Taken.

>insert essence into capacitor
Do I really wanna do this? Chances of me dying are quite high. On the other hand, I will probably die anyway. Careful now. And ..

oh no ..

nonononono

WAIT .. IT WORKED! EUREKA!

>i
You are carrying:
  a spacesuit
  a protector glove (being worn)

>s
Spaceship Storage
Taking a quick look inside the storage room doesn't seem to reveal anything particularly interesting. There are only some random souvenirs from your previous intergalactic travels and your locker which you haven't opened in ages.  It also looks like the airlock in the south doesn't seem to function anymore so perhaps I should go check that out as well?

* * *

>s
Spaceship Exit
The airlock also seems to be affected by the crash and the temperatures inside the spaceship are nearing dangerous levels. I could leave the spaceship right now by going east but I if I don't have something to protect me from the cold I will probably die.

>e
Now that you found a way to stay warm you should be able to leave the spaceship without instantly freezing to death.

Crash Zone
The surface of Kaldríss consists of spiky ice formations as far as the eye can see . No wonder nobody in his right mind would try to land here willingly. There doesn't seem to be anything of interest wherever you look. After taking a closer look you suddenly notice some sort of structure north of your position. If you hurry up you should be able to make it there before you freeze.

* * *

>take all
protector glove: Taken.
encryption key: Taken.

>push button
Beep Boop! Power Unit status: UNLOCKED.

Caution advised.

>open power unit
I only understood you as far as wanting to open the power unit.

>take all
pure flux essence: I totally forgot that I've put this here. This orb holds a huge amount of energy which could be used to power all kinds of devices and possibly even my suit capacitor.

You really shouldn't be touching the pure flux essence without something that protects you from its enormous amounts of energy. This flux essence consists of pure energy and would therefore immediately disintegrate your hand if you touched it without a glove.

>put on glove
You put on the protector glove.

>take all
pure flux essence: I totally forgot that I've put this here. This orb holds a huge amount of energy which could be used to power all kinds of devices and possibly even my suit capacitor.

Taken.

>s
Spaceship Storage
Taking a quick look inside the storage room doesn't seem to reveal anything particularly interesting. There are only some random souvenirs from your previous intergalactic travels and your locker which you haven't opened in ages.  It also looks like the airlock in the south doesn't seem to function anymore so perhaps I should go check that out as well?

* * *

>unlock locker with key
This key seems to fit.  Lock mechanism status: DEACTIVATED // You may proceed to open the locker.

>take all
There are none at all available!

>open locker
You open the locker, revealing an emergency torch and a spacesuit.

>take all
emergency torch: This baby will light up no matter how harsh the conditions are since it uses a special fuel for the ignition process.

Taken.
spacesuit: Taken.

>put on spacesuit
You put on the spacesuit.

>insert essence into capacitor
Do I really wanna do this? Chances of me dying are quite high. On the other hand, I will probably die anyway if I don't try.

>insert essence into capacitor
Do I really wanna do this? Chances of me dying are quite high. On the other hand, I will probably die anyway if I don't try.

(first taking the pure flux essence)
I totally forgot that I've put this here. This orb holds a huge amount of energy which could be used to power all kinds of devices and possibly even my suit capacitor.

This could really work!

>i
You are carrying:
  a spacesuit (being worn)
  an emergency torch
  a protector glove (being worn)

>x spacesuit
Spacesuit Mk. XV with thermodynamic properties as well as other useful stuff.

>drop torch
Dropped.

>s
Spaceship Exit
The airlock also seems to be affected by the crash and the temperatures inside the spaceship are nearing dangerous levels. I could leave the spaceship right now by going east but I if I don't have something to protect me from the cold I will probably die.

* * *

>e
Now that you found a way to stay warm you should be able to leave the spaceship without instantly freezing to death.

Crash Zone
The surface of Kaldríss consists of spiky ice formations as far as the eye can see . No wonder nobody in his right mind would try to land here willingly. There doesn't seem to be anything of interest wherever you look. After taking a closer look you suddenly notice some sort of structure north of your position. If you hurry up you should be able to make it there before you freeze.

>s
You don't want to go there.

>n
Hunting Grounds
Turns out this used to be an explorer camp and you instantly feel a little less lonely and also more safe. Seems like a good place to stay for a while and trying not to freeze to death. But where did those explorers go and why did they leave pretty much everything behind? Further investigations of this place also reveal something resembling a cave entrance that lies underneath the camp.

You can see a stone plate here.

>s
Now that you found a way to stay warm you should be able to leave the spaceship without instantly freezing to death.

Crash Zone
The surface of Kaldríss consists of spiky ice formations as far as the eye can see . No wonder nobody in his right mind would try to land here willingly. There doesn't seem to be anything of interest wherever you look. After taking a closer look you suddenly notice some sort of structure north of your position. If you hurry up you should be able to make it there before you freeze.

>w
Spaceship Exit
The airlock also seems to be affected by the crash and the temperatures inside the spaceship are nearing dangerous levels. I could leave the spaceship right now by going east but I if I don't have something to protect me from the cold I will probably die.

>take torch
You can't see any such thing.

>n
Spaceship Storage
Taking a quick look inside the storage room doesn't seem to reveal anything particularly interesting. There are only some random souvenirs from your previous intergalactic travels and your locker which you haven't opened in ages.  It also looks like the airlock in the south doesn't seem to function anymore so perhaps I should go check that out as well?

You can see an emergency torch here.

>take torch
This baby will light up no matter how harsh the conditions are since it uses a special fuel for the ignition process.

Taken.