Your ship falls through thick layers of dark clouds. Red flashes illuminate your surroundings. The lights on your console warn you of the dangerously fast approaching energy level zero. As you finally break through the last cloud, you get a glimpse of what awaits you underneath. 
Black planes and sharp cliffs of a dark red shape the landscape. In the east you perceive a massive rock formation, in the west you see a thick blue stream cutting through the plane , illuminating big portions of it in the process. Somewhere to the south there seem to be some sort of industrial constructions, far in the north you believe to recognize cubic shapes that reveal a city. You don't have time to study the landscape much longer. All you concentration is desperately needed as you find a gap in the ghastly cliffs and bring down your ship. Heavy jolting, followed by a sudden blow signalize your landing. 
Your ship's on the ground, and you are too, barely. Welcome to Frizza.

Frizza
An Interactive Fiction by Tim
Release 1 / Serial number 170709 / Inform 7 build 6M62 (I6/v6.33 lib 6/12N) SD

Landing Zone
You step out of your ship onto a small square in the middle of nowhere. Your ship's dead and so is the computer. It seems like you ought to explore the environment. You remeber having seen civilization-like shapes to the south-west and to the north. To the east  there is a huge mountain, to the west there seems to be a Flux.

You can see a Discharged Spaceship (in which is a Power Unit (empty)) here.

>n
Wasteland
A pitiful piece of land. Black sand, red rocks and some sickish looking plants. If you are not looking for something particular there is no need to linger.

You can go west, north and south.

I beg your pardon?

I beg your pardon?

>s
Landing Zone
Your crash site. You can go in all directions.

You can see a Discharged Spaceship (empty) here.

* * *

>n
Wasteland
A pitiful piece of land. Black sand, red rocks and some sickish looking plants. If you are not looking for something particular there is no need to linger.

You can go west, north and south.

>w
Flux Gate
An archlike structure stands out against the vastness of the planes. As you approach you become aware of some figures in front of the structure. Strangely, it looks like they were glowing bluishly. At second glance they seem hardly human, you don't know how they will react to your appearance. 

You can go east.

>e
Wasteland
One of the dreary planes in the region.

You can go west, north and south.

>w
Flux Gate
A gate of some sort, guarded.

 You can go east.

>e
Wasteland
One of the dreary planes in the region.

You can go west, north and south.

>s
Landing Zone
Your crash site. You can go in all directions.

You can see a Discharged Spaceship (in which is a Power Unit (empty)) here.

>se
You can't go that way.

>e
Ascent
The mountains are composed of stone in various shades of red and reach far to the sky. In between the cliffs and sheers you see a narrow path winding up. There is no clue on where it might lead, but you could find out.

You can go west and up.

>uo
That's not a verb I recognise.

>x
What do you want to examine?

>u
You see nothing unexpected in that direction.

>x
What do you want to examine?

* * *

>s
Landing Zone
Your crash site. You can go in all directions.

You can see a Discharged Spaceship (in which is a Power Unit (empty)) here.

>e
Ascent
The mountains are composed of stone in various shades of red and reach far to the sky. In between the cliffs and sheers you see a narrow path winding up. There is no clue on where it might lead, but you could find out.

You can go west and up.

>up
You have the feeling of being watched. You wouldn't want to climb the cliffs if someone is around.

>x
(Dunia)
A lean but athletic figure, wrapped by several layers of what looks like tough leather. In a small gap of her hood you can see glinting eyes that reveal a sharp mind.

You are painfully near to trespass holy ground, stranger. I would advise against it. Who are you, anyway? You don't look like a Techie. Tell me your name.

>e
You see no way to climb the steep cliffs in this direction.

>w
Landing Zone
Your crash site. You can go in all directions.

You can see a Discharged Spaceship (in which is a Power Unit (empty)) here.

>n
Wasteland
One of the dreary planes in the region.

You can go west, north and south.

>w
Flux Gate
A gate of some sort, guarded.

You can go east.

>e
Wasteland
One of the dreary planes in the region.

You can go west, north and south.

* * *

>s
Landing Zone
Your crash site. You can go in all directions.

You can see a Discharged Spaceship (in which is a Power Unit (empty)) here.

>e
Ascent
The foot of the mountain. 

A narrow path leads upwards. You can also go west.

You can see Dunia here.

>x Duna
You can't see any such thing.

>x Dunia
A lean but athletic figure, wrapped by several layers of what looks like tough leather. In a small gap of her hood you can see glinting eyes that reveal a sharp mind.

* * *

>w
Flux Gate
An archlike structure stands out against the vastness of the planes. As you approach you become aware of some figures in front of the structure. Strangely, it looks like they were glowing bluishly. At second glance they seem hardly human, you don't know how they will react to your appearance. 

You can go east.

>x
What do you want to examine?

>look
Flux Gate
An archlike structure stands out against the vastness of the planes. As you approach you become aware of some figures in front of the structure. Strangely, it looks like they were glowing bluishly. At second glance they seem hardly human, you don't know how they will react to your appearance. 

You can go east.

>x gate
You can't see any such thing.

>e
Wasteland
One of the dreary planes in the region.

You can go west, north and south.

* * *

>e
Ascent
The mountains are composed of stone in various shades of red and reach far to the sky. In between the cliffs and sheers you see a narrow path winding up. There is no clue on where it might lead, but you could find out.

You can go west and up.

>u
You have the feeling of being watched. You wouldn't want to climb the cliffs if someone is around.

>x
(Dunia)
A lean but athletic figure, wrapped by several layers of what looks like tough leather. In a small gap of her hood you can see glinting eyes that reveal a sharp mind.

You are painfully near to trespass holy ground, stranger. I would advise against it. Who are you, anyway? You don't look like a Techie. Tell me your name.

>ask Dunia about iinform
- Answer my question first. What is your name?

>answer Axesto
(to Dunia)
What a strange name. It doesn't matter anyway - there's only one thing I need to know: are you on the side of the Techies or of the Duju?

>answer Duju
(to Dunia)
Well then, that's not a bad way to start. Thinking about it - an outsider might be what we need. I'll introduce you to someone, and that is not an invitation.

 With seemingly little effort she climbs down the cliffs to your level, before insistently inviting you to come with her.
 Both of you walk through the scraggy landscape, her leading the way with distinct commands. Slowly you approach an archlike structure, close to one branch of the Flux. As you get nearer you perceive a couple of bulky shapes, guarding the entrance to the structure. Some hundred metes in front of the entrance your companion turns to you. 

Try not to look too provoking.

You know why while passing the guards: each and every one of them gazes at you. In consideration of the thick armour plates, the rather oversized guns and their radiating blue glow you refrain from making any quick motions.

Flux Gate
A gate of some sort, guarded.

You can go east.

Inside you find yourself in the midst of a small-sized hall, that doesn't appear to justify any of the expenditure you just encountered. In the back you spot an opening and a staircase, leading downwards. To the left there is a full board of controls and two figures unhastily operating them. You can't look around any more, as you are approached quickly by an impressive sized person, already bellowing a few direct words with a booming voice.

Dunia! Who is this? Explain yourself!

A guest of sorts. He stumbled about the Ascent when I found him. I don't think he's a Techie, at least he has a slightly better manners and he keeps his voice down to a sensible level when talking. Besides, I thought about his use in regard to certain issues, due to his undujulike appearance.

Both eyeball you thoroughly for what seems to you like hours. Eventually, the massive Duju makes a quick motion towards Dunia, indicating her to follow him. He shoots a last glance at you.

Don't let yourself be found sniffing around somewhere, it would not contribute to your wellbeing.

 They march off, disappearing into the opening at the end of the hall. You are not guarded, it seems like you could look around. Of course you could also do as you were told and wait.

>look
Flux Gate
A gate of some sort, guarded.

You can go east.

You can see a console, a weapon's rack (on which is a gun), Duju Operator 1 and Duju Operator 2 here.

>x rack
An ugly but pracitcal piece of furniture, made to store weaponry.

On the weapon's rack is a gun.

>take rack
That would be rather unpractical to carry.

>take console
It's huge. Besides, you don't even dare touch it.

>take operator
Who do you mean, Duju Operator 1 or Duju Operator 2?

>take operator 1
They don't look like they would fancy physical contact.

>x myself
Good-looking as ever.

>e
They won't let you go until your two companions have returned.

>wait
You stand still where you were left. Time passes. However, that seems to be the only thing to change.

>wait
You pass the time looking closer at your surroundings, but you can't interpret all too much from the metallic alien structures. The architecture somewhat reminds you of the spiritual buildings on your home planet, as for the arching walls and the high ceiling. The only thing you hear is the distant, lamish flow of the Flux and the dull sounds of the two operators at the console.

>wait
Finally you see the two Duju returning from the opening. As they approach, the big one actually looks amazed by your decent behaviour.

It seems like you did as you were told. Maybe you don't have no ill intent after all. Indeed - that is exactly what we're going to find out, if you're willing. But you see, we don't want to force anything on you, you are free to leave. But if you are interested in helping us, we would be glad.

He hands you something that distantly reminds you of a fishing net, only is this one almost ridiculously overengineered. You must have a rather puzzled look to your face, as Du'un starts to explain soon after. 

That is a Flux Extractor, the Techies call them "Scoops". It is used to extract small portions of the Flux and isolate it for examination. If you want to help us out, showing us that you have no evil intent in the process, go and extract two samples of the Flux, one from the current before it passes through this gate, and one after it has done so. I am sure you will find the proper locations for this purpose yourself. When you are done or have any questions, return here, Dunia will be to your assistance.

You receive a Flux Extractor.

With that, Du'un goes off, quickly descending the stairs at the back of the hall. You are left with a vague task and Dunia, who doesn't look very pleased.

To your assitance, eh? Well, better than climbing that awful piece of a mountain, I suppose.

>ask Dunia about cloak
There is no reply.

>ask Dunia about Extractor
There is no reply.

>ask Dunia about Flux Extractor
She giggles a bit.

It is simple, you will see when you get to the Flux. Just dip it in.

She shows a devilish grin. Oh, but there's something I can help you with.

Suddenly Dunia grasps a corner of her leathery clothing and, with one swoosh, unwraps it from her body. Underneath, a sinewy, bluish body comes to appearance.

Here, take this, it will prevent the Flux from disintegrating you all too fast.

The devilish grin emerges again.

And stop staring.

You receive a Sinkan Cloak.

>wear Cloak
You put on the Sinkan Cloak.

>e
Wasteland
One of the dreary planes in the region.

You can go west, north and south.

>n
Verge of the Bloo City
An averagely sized city extends in front of you. Its cityscape is dominated by an enormous building in the rear part, not resembling any architecture that you have ever seen. Halfway to it there seems to be some sort of city center. The city is surrounded by a foreign sort of fencing, with a gate not far form you.

You can go west, north and south.

>w
Flux beyond the Gate
Another current of the Flux. Even from the distance you feel the pure energy flooding your body. It appears to have a slightly different viscosity than the other Fluxes, maybe it has something to do with the Flux Gate arking above the Flux in the south.

You can go east.

You can see a Regulated Flux Current here.

>approach current
Very cautiously you approach the Flux. While coming nearer, each step feels like pumping pure electrictiy into the ground. Your whole body swings in an unknown rhythm. You are only a few steps away now. The Flux flowing lamishly as ever, blistering, throwing arcs of bluish vapor. You feel your atoms slowly leaving their place, starting to rearrange. You take one step after the other, always expecting that your legs will come apart with the next one. Finally, you reach the pedestal. As you crawl onto it, you feel your mind dissolving, your synapses strewing about. You are becoming the Flux.

>extract
(sample from the Regulated Flux Current)
You thrust your arm over the ledge, despairingly clasping the Flux Extractor, not knowing whether your arm will dematerialize in an instant. The Extractor extends automatically and dips its head into the glowing liquid. You think to hear a beeping sound. It blurs, as your mind dives into the Flux, becomes energy. You perceive magnetic fields, penetrated by some foreign control. You feel the stream, the Flux arranging itself, its symbioses with the planet. You feel the life essence of the Duju, feeding from the Flux. And you feel its core, more powerful than any other source you ever knew, burried deep down in the caverns. Still you have a slim link to your body, but it trembles and shakes heavily. Finally, your hear a tedious, enduring beeping sound. The Flux Extractor is finished, it now carries a sample of the Flux. You force yourself to crawl down the pedestal, your hands feeling like they would disintegrate any moment, their contours growing hazy. With each step you take away from the Flux, your mind and body recover their focus. You drag yourself up the shore and up the cliffs, before collapsing on the rocky soil.

You wake up.

You receive a Regulated Flux Essence.

>x myself
Everything seems usual at first. Your mind and body are where you remeber them. You take a long glance at the Flux, casually taking its path. For a second, you are terrified, then you calm yourself and wonder if that all really happened. You look at the Cloak you are wearing - the same old strange leather, you think. But ... some of the edges appear to have changed their course, and the leather itself too seems to be contorted somehow ... you don't want to wonder what would have happened if you didn't have the cloak. You silently send a belssing to Dunia and stand up.

>e
Verge of the Bloo City
The pathway into the alien city. 

You can go west, north and south.

>w
Flux beyond the Gate
A branch of the Flux, it emerges from under the Flux Gate to the south.

You can go east.

You can see a Regulated Flux Current here.

>x myself
As good-looking as ever. Only ... you thought you had a spot on that left hand of yours, which is gone now ...

>e
Verge of the Bloo City
The pathway into the alien city. 

You can go west, north and south.

>s
Wasteland
One of the dreary planes in the region.

You can go west, north and south.

>s
Landing Zone
Your crash site. You can go in all directions.

You can see a Discharged Spaceship (in which is a Power Unit (empty)) here.

>w
Flux
A viscous current of blue fluid cuts through the plane.  You need to screen your eyes from the radiating light to not become blinded. Even at this distance you feel the Flux" presence in your body, as if your atoms were spinning three times their normal pace. You don't know if it's a good idea to approach it further.

You can go east and south.

You can see an Unregulated Flux Current here.

>x rock
A huge, slender rock looms at the shore of the Flux. It would make a good land to the Flux. It doesn't seem to stand all too stable, if you could only knock it over with something ...

>e
Landing Zone
Your crash site. You can go in all directions.

You can see a Discharged Spaceship (in which is a Power Unit (empty)) here.

>n
Wasteland
One of the dreary planes in the region.

You can go west, north and south.

>w
Flux Gate
A gate of some sort, guarded.

You can go east.

You can see Dunia, a console, a weapon's rack (on which is a gun), Duju Operator 1 and Duju Operator 2 here.

>ask Dunia about gun
Ah, I see, you look for a way to get down to the current. Well, the gun is not what will help you, even if I gave it to you, which I won't, you still needed to fire it, which you can't. So erase that thought. However ... what might help you ... wait a moment.

 Dunia turns to the rack, which the gun lies on, and resolutely approaches it. With a few precise movements she breaks loose one of the bars framing the rack, accompanied by a bright clang. Even the guards take a short glance, before respectfully turning to the entrance again. Triumphantly, Dunia returns to you and hands you the bar with a smirk. 

Congratulations, you are now the owner of a convenient lifting tool.

You receive a Miserable Lever.

>e
Wasteland
One of the dreary planes in the region.

You can go west, north and south.

* * *

>s
Landing Zone
Your crash site. You can go in all directions.

You can see a Discharged Spaceship (in which is a Power Unit (empty)) here.

>w
Flux
The main Flux current of the region. A huge rock loosely stands at its shores.

You can go east and south.

You can see an Unregulated Flux Current here.

>push rock
You thrust the bar into the soil under the rock and start levering. Even with the amplified force you need your whole body to move the rock. Finally, it staggers, and with a last effort you make it topple over. The rock slowly tilts and then continues, with a mighty rumble, to drop into the flux, sending huge waves to both sides. You now have a descent into the Flux. However, your already miserable Lever now is little more than a bent piece of metal, you leave it on the ground

>approach current
With little effort you climb down your newfound ramp. As you come closer to the Flux, you feel your body resonating, feeling as if it would prefer to dissolve. Quickly, you extend the Extractor into the Flux and try to keep your fluttering mind together, while hearing the beeping sound. Shorty, you have visions of a brute Duju, clad in plates of thick metal, thorns protruding from the shoulders. Then a lean figure, wrapped in a long black robe, operating some sort of complex device in front of what seems to you like an altar. A penetrating beeping draws you out of your sight. The Extractor is finished. You scramble up to the shore and quickly bring some distance between you and the Flux, your mind and body slowly regaining their place. 

You receive an Unregulated Flux Essence.

>e
Landing Zone
Your crash site. You can go in all directions.

You can see a Discharged Spaceship (in which is a Power Unit (empty)) here.

>i
You are carrying:
  a Sinkan Cloak (being worn)
  a Flux Extractor
    an Unregulated Flux Essence
    a Regulated Flux Essence

>put cloak in spaceship
That wouldn't be of much use. The only thing that sincerely needs maintenance is the Power Unit.

>put cloak in power unit
That wouldn't generate much energy. You need a real power source.

>e
Ascent
The mountains are composed of stone in various shades of red and reach far to the sky. In between the cliffs and sheers you see a narrow path winding up. There is no clue on where it might lead, but you could find out.

You can go west and up.

* * *

>u
You have the feeling of being watched. You wouldn't want to climb the cliffs if someone is around.

>x
What do you want to examine?

* * *

>u
You see nothing unexpected in that direction.

>look
Ascent
The mountains are composed of stone in various shades of red and reach far to the sky. In between the cliffs and sheers you see a narrow path winding up. There is no clue on where it might lead, but you could find out.

You can go west and up.

You can see Dunia here.

>u
You have been made clear that your ascension of the mountain is unwished for - better leave that rocky misery where you found it.

>u
You have been made clear that your ascension of the mountain is unwished for - better leave that rocky misery where you found it.

* * *

>m
That's not a verb I recognise.

>n
Wasteland
A pitiful piece of land. Black sand, red rocks and some sickish looking plants. If you are not looking for something particular there is no need to linger.

>undo
Landing Zone
[Previous turn undone.]

>undo
You can't "undo" what hasn't been done!

>save
Save failed.

>save
Ok.

* * *

>restore
Ok.

>n
Wasteland
A pitiful piece of land. Black sand, red rocks and some sickish looking plants. If you are not looking for something particular there is no need to linger.

>n
Verge of the Bloo City
An averagely sized city extends in front of you. Its cityscape is dominated by an enormous building in the rear part, not resembling any architecture that you have ever seen. Halfway to it there seems to be some sort of city center. The city is surrounded by a foreign sort of fencing, with a gate not far form you.

>n
You can't even say for sure if they will speak to you before killing you. It would be unwise to approach.