Your ship falls through thick layers of dark clouds. Red flashes illuminate your surroundings. The lights on your console warn you of the dangerously fast approaching energy level zero. As you finally break through the last cloud, you get a glimpse of what awaits you underneath. 
Black planes and sharp cliffs of a dark red shape the landscape. In the east you perceive a massive rock formation, in the west you see a thick blue stream cutting through the plane , illuminating big portions of it in the process. Somewhere to the south there seem to be some sort of industrial constructions, far in the north you believe to recognize cubic shapes that reveal a city. You don't have time to study the landscape much longer. All you concentration is desperately needed as you find a gap in the ghastly cliffs and bring down your ship. Heavy jolting, followed by a sudden blow signalize your landing. 
Your ship's on the ground, and you are too, barely. Welcome to Frizza.

On the Lookout
An Interactive Fiction by Daniel, Franziska, Tim, Kevin, Tobias
Release 1 / Serial number 170712 / Inform 7 build 6M62 (I6/v6.33 lib 6/12N) SD

Your arrival point. The Flat Rock
You arrive on a planet called Sitis. You think the landing went great but as you leave your spaceship, you realise that two of your three water container broke down. Without minimum one new watertank you can not continue your journey. Far away in the east you recognise some kind of different rooftops. Maybe someones living there who could help you?

You can see Teleportation Stone - Sitis, Teleportation Stone - Gaisetto, Teleportation Stone - Geysiria, Teleportation Stone - Frizza and Teleportation Stone - Kaldríss here.

>take frizza
Landing Zone
You step out of your ship onto a small square in the middle of nowhere. Your ship's dead and so is the computer. It seems like you ought to explore the environment. You remeber having seen civilization-like shapes to the south-west and to the north. To the east  there is a huge mountain, to the west there seems to be a Flux.

You can see a Discharged Spaceship (in which is a Power Unit (empty)) here.

>n
Wasteland
A pitiful piece of land. Black sand, red rocks and some sickish looking plants. If you are not looking for something particular there is no need to linger.

You can go west, north and south.

* * *

>kaldríss
That's not a verb I recognise.

>Kaldríss
That's not a verb I recognise.

>kaldriss
That's not a verb I recognise.

>take Kaldríss
Spaceship Bridge
The place where all the magic happens. Well, it used to be at least - during the impact most of the important equpiment including the communication systems must have been fried and doesn't seem to work anymore.  There's only a single flickering light inside the command panel. What could this mean? I should probably open the command panel and take a look. I could also go south and check the storage of the spaceship first.

>x command panel
You see nothing special about the command panel.

You could open this baby up and take a peak inside.

>open panel
You open the command panel, revealing a protector glove, a fried communicator, a power reserve, a green button and an encryption key.

>take all
Teleportation Stone - Kaldríss: Spaceship Bridge
The place where all the magic happens. Well, it used to be at least - during the impact most of the important equpiment including the communication systems must have been fried and doesn't seem to work anymore.  There's only a single flickering light inside the command panel. What could this mean? I should probably open the command panel and take a look. I could also go south and check the storage of the spaceship first.

You can see Teleportation Stone - Frizza, Teleportation Stone - Geysiria, Teleportation Stone - Gaisetto and Teleportation Stone - Sitis here.

Teleportation Stone - Frizza: Landing Zone
You step out of your ship onto a small square in the middle of nowhere. Your ship's dead and so is the computer. It seems like you ought to explore the environment. You remeber having seen civilization-like shapes to the south-west and to the north. To the east  there is a huge mountain, to the west there seems to be a Flux.

You can see a Discharged Spaceship (in which is a Power Unit (empty)) here.

(Since something dramatic has happened, your list of commands has been cut short.)

>drop all
(the backpack)
(first taking the backpack off)
Dropped.

* * *

>take kaldríss
Spaceship Bridge
The place where all the magic happens. Well, it used to be at least - during the impact most of the important equpiment including the communication systems must have been fried and doesn't seem to work anymore.

There's only a single flickering light inside the command panel.

What could this mean? I should probably open the command panel and take a look. I could also go south and check the storage of the spaceship first.

>open command panel
You manage to remove the protective layer of the command panel revealing the mainframe with all the important stuff.  Usually it's not advised to do this by yourself but tough times call for tough measures.

>x command panel
In the command panel are a protector glove, a fried communicator, a power reserve, a green button and an encryption key.

You could open this baby up and take a peak inside.