On the Lookout
An Interactive Fiction by Daniel, Franziska, Tim, Kevin, Tobias
Release 1 / Serial number 170711 / Inform 7 build 6M62 (I6/v6.33 lib 6/12N) SD

Your arrival point. The Flat Rock
You arrive on a planet called Sitis. You think the landing went great but as you leave your spaceship, you realise that two of your three water container broke down. Without minimum one new watertank you can not continue your journey. Far away in the east you recognise some kind of different rooftops. Maybe someones living there who could help you?

>take frizza
Landing Zone
You step out of your ship onto a small square in the middle of nowhere. Your ship's dead and so is the computer. It seems like you ought to explore the environment. You remeber having seen civilization-like shapes to the south-west and to the north. To the east  there is a huge mountain, to the west there seems to be a Flux.

You can see a Discharged Spaceship (empty) here.

* * *

On the Lookout
An Interactive Fiction by Daniel, Franziska, Tim, Kevin, Tobias
Release 1 / Serial number 170711 / Inform 7 build 6M62 (I6/v6.33 lib 6/12N) SD

Your arrival point. The Flat Rock
You arrive on a planet called Sitis. You think the landing went great but as you leave your spaceship, you realise that two of your three water container broke down. Without minimum one new watertank you can not continue your journey. Far away in the east you recognise some kind of different rooftops. Maybe someones living there who could help you?

>e
The Wide Desert
You've reached the Desert of Sitis. It gives you two things: First, an impression of what whole Sitis looks like - sandy, dry, with some deep stone canyons and huge rocks afar. But although this planet does not seem to be a place to life, the Desert also gives you the chance to discern that you are not alone. There IS life! When you look north, directly in front of you is a long corrugated iron bridge, guiding over one of those ravines. You can not access the bridge, it is blocked with a barbed wire fence, but straight ahead, at the end you see a majestic sandstone palace. In the bridge's middel, a wooden ladder leads to an enormous square block in the east. Likewise it is built out of stone and gives a somber impression. If you look east from the point you are standing at right now, you see the kind of a rock mine. In the south you recognise a lot of small white houses surrounded by a rampart. It seems like people are living here.

>s
The Rampart around Sicuum
You can see a wooden gate here.

>open gate
Someone is yelling at you. "Who are you? And what do you want?"

>answere axesto
That's not a verb I recognise.

>e.
You don't want to go there.

>answer axesto_sitis
(to the the faceless guardian)
There is no reply.

>answer axesto
(to the the faceless guardian)
I am Axesto, an alien of the planet Fidatis. I landed here because I am travelling through the whole galaxy to discover the life on other plantes. During the landing here, two of my water containers broke down. That's why I need you to ask for water. Can you give me a bit, please? 

First there's silence. Then the gate squeaks. It opens slowly.

>help
That's not a verb I recognise.

>helper
---
 This is the help section, you will get a list of essential commands that you can use in the game.

look - shows you the room you are currently in
 e(x)amine (something)- get information about a thing or a person (if no object or person is specified, something will be examined automatically, if it's the only thing in the room
 take (something) - take and carry something
 (i)nventory - examine what your are carrying

(e)ast - go east
 (w)est - go west
 (s)outh - go south
 (n)orth - go north

Frizza
 ask (someone) about (something) - the typical way to begin a dialogue, the topics you can ask about are printed bold in the text beforehand
 answer (something) to (someone) - the typical way to respond to questions, the topics you can answer are printed bold in the text beforehand
 wait - wait some time, some situations may require this
 wear (something) - put clothing on
 take off (something )- take off clothing
 approach (something)-  try to draw closer to an object, some situations may require this
 extract - extract a sample from the Flux Current

Kaldríss
 open/close (something)
 unlock/lock (something)
 insert (something) into (something)
 remove (something) from (something)
 shove (something) aside - some situations with blocked paths may require this
 put (something) on (e.g. clothing)
 follow (someone) - you are able to follow the movement of another character

End of help section
---

>l
The Rampart around Sicuum

>i
You are carrying:
  a backpack (being worn)
  suit capacitor (being worn)

>x
What do you want to examine?

>Investigate
You can't see any such thing.

>l around
You can't see any such thing.

>n
The Wide Desert
You've reached the Desert of Sitis. It gives you two things: First, an impression of what whole Sitis looks like - sandy, dry, with some deep stone canyons and huge rocks afar. But although this planet does not seem to be a place to life, the Desert also gives you the chance to discern that you are not alone. There IS life! When you look north, directly in front of you is a long corrugated iron bridge, guiding over one of those ravines. You can not access the bridge, it is blocked with a barbed wire fence, but straight ahead, at the end you see a majestic sandstone palace. In the bridge's middel, a wooden ladder leads to an enormous square block in the east. Likewise it is built out of stone and gives a somber impression. If you look east from the point you are standing at right now you see the kind of a rock mine. In the south you recognise a lot of small white houses surrounded by a rampart. It seems like people are living here.

>s
The Rampart around Sicuum

>l at gate
open.

>s
The Agora of Sicuum
You enter the wooden gate. Finally, you do not just expect other people, rather you see them. The Sitisianer, that is how they are called, looks different then you. They are taller, with longer legs and shorter necks. Also they definitely got more hair. But their faces seems to be drawn by life. You really do not know how to connect to these people without scaring them. Maybe you should look around for the one who has opened the gate for you.

>n
The Rampart around Sicuum

>enter gate
The Agora of Sicuum
You enter the wooden gate. Finally, you do not just expect other people, rather you see them. The Sitisianer, that is how they are called, looks different then you. They are taller, with longer legs and shorter necks. Also they definitely got more hair. But their faces seems to be drawn by life. You really do not know how to connect to these people without scaring them. Maybe you should look around for the one who has opened the gate for you.

>l
The Agora of Sicuum
You enter the wooden gate. Finally, you do not just expect other people, rather you see them. The Sitisianer, that is how they are called, looks different then you. They are taller, with longer legs and shorter necks. Also they definitely got more hair. But their faces seems to be drawn by life. You really do not know how to connect to these people without scaring them. Maybe you should look around for the one who has opened the gate for you.

You realize a boy staring at you. His name must be Anaidis because someone calls him "Anaidis, catching is about running after the other ones, not staring around!" What about connecting to him?

>x Anaidis_sitis
You see nothing special about The staring boy.

The boy takes a step back. He radiates a mixture of fear and fascination. "You have spoken about finding water. You will not be successful here."

>Ask Anaidis_sitis about No Water
Anaidis shakes his head. "I have never said we do not have any water here. Of course we do need water to survive. But we also need to fight for it. That's the reason we're not giving it away easily. Especially not to total strangers. 

You are not quite sure how to react to Anaidis statement. He seems to see this. So he starts to smile and mentions "Don't worry - it's less about you. It's more about our history. I know someone who could make you understanding these things. Come with me!"  Anaidis walks west to a huge hut. Follow him!

>follow Anaidis
That's not a verb I recognise.

>Helper
---
 This is the help section, you will get a list of essential commands that you can use in the game.

look - shows you the room you are currently in
 e(x)amine (something)- get information about a thing or a person (if no object or person is specified, something will be examined automatically, if it's the only thing in the room
 take (something) - take and carry something
 (i)nventory - examine what your are carrying

(e)ast - go east
 (w)est - go west
 (s)outh - go south
 (n)orth - go north

Frizza
 ask (someone) about (something) - the typical way to begin a dialogue, the topics you can ask about are printed bold in the text beforehand
 answer (something) to (someone) - the typical way to respond to questions, the topics you can answer are printed bold in the text beforehand
 wait - wait some time, some situations may require this
 wear (something) - put clothing on
 take off (something )- take off clothing
 approach (something)-  try to draw closer to an object, some situations may require this
 extract - extract a sample from the Flux Current

Kaldríss
 open/close (something)
 unlock/lock (something)
 insert (something) into (something)
 remove (something) from (something)
 shove (something) aside - some situations with blocked paths may require this
 put (something) on (e.g. clothing)
 follow (someone) - you are able to follow the movement of another character

End of help section
---

>l
The Agora of Sicuum
You can see Machitikos, The Great Scorpius and Anaidis here.

>w
The Domum Praesidium of Sicuum
As you enter, you see a long table standing in the middle of a spacious room, with a lot of chairs around and kind of executive chair at the tabel's end. So, this huge sandy hut seems to have an official function. During you are still thinking about to whom you are going to speak right now, Anaidis already walks straight ahead into a smaller room. Hurry up! Otherwise you maybe going to lose him.

* * *

>s
The Rampart around Sicuum
You can see a wooden gate here.

>x wooden gate
It seems to be closed. Let's try to open it.

>open wooden gate
Someone is yelling at you. "Who are you? And what do you want?"

>answer Axesto
(to the the faceless guardian)
I am Axesto, an alien of the planet Fidatis. I landed here because I am travelling through the whole galaxy to discover the life on other plantes. During the landing here, two of my water containers broke down. That's why I need you to ask for water. Can you give me a bit, please? 

First there's silence. Then the gate squeaks. It opens slowly.

>s
The Agora of Sicuum
You enter the wooden gate. Finally, you do not just expect other people, rather you see them. The Sitisianer, that is how they are called, looks different then you. They are taller, with longer legs and shorter necks. Also they definitely got more hair. But their faces seems to be drawn by life. You really do not know how to connect to these people without scaring them. You should look around for the one who has opened the gate for you.

>look around
You can't see any such thing.

>look
The Agora of Sicuum
You enter the wooden gate. Finally, you do not just expect other people, rather you see them. The Sitisianer, that is how they are called, looks different then you. They are taller, with longer legs and shorter necks. Also they definitely got more hair. But their faces seems to be drawn by life. You really do not know how to connect to these people without scaring them. You should look around for the one who has opened the gate for you.

You realize a boy staring at you. His name must be Anaidis because someone calls him "Anaidis, catching is about running after the other ones, not staring around!" What about connecting to him?

>x anaidis
You can't see any such thing.

>x anaidis_sitis
You see nothing special about The staring boy.

The boy takes a step back. He radiates a mixture of fear and fascination. "You have spoken about finding water. You will not be successful here."

>ask anaidis_sitis about why not
There is no reply.

>ask anaidis_sitis about water
There is no reply.

>ask anaidis about why not
You can't see any such thing.

>ask anaidis_sitis about water
There is no reply.

>ask anaidis_sitis about why not
There is no reply.

>ask anaidis_sitis about why not
There is no reply.

>ask anaidis_sitis about no success
Anaidis shakes his head. "I have never said we do not have any water here. Of course we do need water to survive. But we also need to fight for it. That's the reason we're not giving it away easily. Especially not to total strangers.

You are not quite sure how to react to Anaidis statement. He seems to see this. So he starts to smile and mentions "Don't worry - it's less about you. It's more about our history. I know someone who could make you understanding these things. Come with me!"  Anaidis walks west to a huge hut. Follow him!

>ask anaidis about no success
You can't see any such thing.

>ask anaidis about water
You can't see any such thing.

>ask anaidis about why not
You can't see any such thing.

>ask anaidis about why not
You can't see any such thing.

>w
The Domum Praesidium of Sicuum
As you enter, you see a long table standing in the middle of a spacious room, with a lot of chairs around and kind of executive chair at the tabel's end. So, this huge sandy hut seems to have an official function. During you are still thinking about to whom you are going to speak right now, Anaidis already walks straight ahead into a smaller room. Hurry up! Otherwise you maybe going to lose him.

>n
Mitéra's Room
You can see Anaidis and Mitéra here.

>x mitéra_Sitis
Mitéra is a small and wrinkled woman. At the moment she lies on a narrow enhancement out of stone. It seems to be her bed. Anaidis kneels on the ground next to her whispering something incomprehensible. Suddenly, she gets up, actuates you and then her eyes lighten up. 

"Hello stranger! My name is Mitéra, I am the protectress of my loved ones here in Sicuum. Anaidis mentioned you are searching for water. Is that right?"

You nod. It feels like Mitéra is trusting you. She continues.

"You know, Axesto, there was a time, when our village Sicuum and the whole planet Sitis has been a lovely, peaceful and vivid place. Of course - the environment always resembled a desert. But we've had some plants, we've had some animals living here and especially we've had different water sources. These sources have been all around. You never needed to walk a long time until you've found one. But then, there came Scorpius..."

Suddenly you hear loud noises from the Agora. Kids are screaming, parents are calling them concerned and deep male voices are yelling "Out of our way! Out of HIS way!" Anaidis runs shocked out of the room. First, you want to follow him, but then you focuse on Mitéra again. However, she directly signals, you should go after him. So, what are you waiting for?

>n
You can't go that way.

>s
The Domum Praesidium of Sicuum

>look
The Domum Praesidium of Sicuum

>w
You can't go that way.

>e
The Agora of Sicuum
You can see Anaidis, Machitikos and The Great Scorpius here.

>ask anaidis about the great scorpius
You can't see any such thing.

>ask anaidis_sitis about the great scorpius
Anaidis whispers, "He is a dictator. Earlier, Scorpius was one of us. Beschreibung fehlt. Right now - he's forcing us every week to fight against his strongest warrior. If you win, you will get two full keg of water. If you lose... you have to try to survive one week without new water. So. This is the answer you were looking for. Are you going to fight?"

You hesitate few seconds. This gladiator Machitikos looks highly dangerous. He is tall, muscular and Beschreibung fehlt. But you feel determined - you are going to beat him. For yourself and for the repressed Sitisianer. You step directly in front of the great Scorpius.

>x the great scorpius_sitis
You can't see any such thing.

>x scorpius_sitis
You see nothing special about The Great Scorpius.

Scorpius sits on a high wooden throne. "What do you want? You little deformed bastard?!" You answer assertive. 

"I wanna fight. I wanna fight against your bastard Machitikos."

All the people around you start whispering fluttered. Scorpius stares at you incredulous. 

"So... go on. Abortion!

>x machitikos_sitis
You see nothing special about Machitikos.

Machitikos does not say a word. He just grunts aggressively and throws two weapons in front of you: a long sharp spear and a huge spiked mace. Which one do you take?

>take spear_sitis
The moment you took the spear, Machitikos straight begins to attac you with the spiked mace. Beschreibung fehlt. But finally - you bet him!

* * *

>open wooden gate
Someone is yelling at you. "Who are you? And what do you want?"

>answer axesto
(to the the faceless guardian)
I am Axesto, an alien of the planet Fidatis. I landed here because I am travelling through the whole galaxy to discover the life on other plantes. During the landing here, two of my water containers broke down. That's why I need you to ask for water. Can you give me a bit, please? 

First there's silence. Then the gate squeaks. It opens slowly.

>s
The Agora of Sicuum
You enter the wooden gate. Finally, you do not just expect other people, rather you see them. The Sitisianer, that is how they are called, looks different then you. They are taller, with longer legs and shorter necks. Also they definitely got more hair. But their faces seems to be drawn by life. You really do not know how to connect to these people without scaring them. You should look around for the one who has opened the gate for you.

>look
The Agora of Sicuum
You enter the wooden gate. Finally, you do not just expect other people, rather you see them. The Sitisianer, that is how they are called, looks different then you. They are taller, with longer legs and shorter necks. Also they definitely got more hair. But their faces seems to be drawn by life. You really do not know how to connect to these people without scaring them. You should look around for the one who has opened the gate for you.

You realize a boy staring at you. His name must be Anaidis because someone calls him "Anaidis, catching is about running after the other ones, not staring around!" What about connecting to him?

* * *

>x anaidis_sitis
You see nothing special about The staring boy.

The boy takes a step back. He radiates a mixture of fear and fascination. "You have spoken about finding water. You will not be successful here."

>ask anaidis_sitis about no success
Anaidis shakes his head. "I have never said we do not have any water here. Of course we do need water to survive. But we also need to fight for it. That's the reason we're not giving it away easily. Especially not to total strangers.

You are not quite sure how to react to Anaidis statement. He seems to see this. So he starts to smile and mentions "Don't worry - it's less about you. It's more about our history. I know someone who could make you understanding these things. Come with me!"  Anaidis walks west to a huge hut. Follow him!

>w
The Domum Praesidium of Sicuum
As you enter, you see a long table standing in the middle of a spacious room, with a lot of chairs around and kind of executive chair at the tabel's end. So, this huge sandy hut seems to have an official function. During you are still thinking about to whom you are going to speak right now, Anaidis already walks straight ahead into a smaller room. Hurry up! Otherwise you maybe going to lose him.

* * *

>n
Mitéra's Room
You can see Anaidis and Mitéra here.

>x mitéra_sitis
Mitéra is a small and wrinkled woman. At the moment she lies on a narrow enhancement out of stone. It seems to be her bed. Anaidis kneels on the ground next to her whispering something incomprehensible. Suddenly, she gets up, actuates you and then her eyes lighten up. 

"Hello stranger! My name is Mitéra, I am the protectress of my loved ones here in Sicuum. Anaidis mentioned you are searching for water. Is that right?"

You nod. It feels like Mitéra is trusting you. She continues.

"You know, Axesto, there was a time, when our village Sicuum and the whole planet Sitis has been a lovely, peaceful and vivid place. Of course - the environment always resembled a desert. But we've had some plants, we've had some animals living here and especially we've had different water sources. These sources have been all around. You never needed to walk a long time until you've found one. But then, there came Scorpius..."

Suddenly you hear loud noises from the Agora. Kids are screaming, parents are calling them concerned and deep male voices are yelling "Out of our way! Out of HIS way!" Anaidis runs shocked out of the room. First, you want to follow him, but then you focuse on Mitéra again. However, she directly signals, you should go after him. So, what are you waiting for?

>look
Mitéra's Room
You can see Mitéra here.

>x mitéra
You can't see any such thing.

>x mitéra_sitis
The old woman is friendly looking at you.

>s
The Domum Praesidium of Sicuum

>e
The Agora of Sicuum
As you arrive at the Agora, you just wanna know what this Scorpius did. Specially, when you see, how the people are reacting to him. So use your chance, ask Anaidis about.

You can see Anaidis, Machitikos and The Great Scorpius here.

>ask anaidis_sitis about Scorpius
There is no reply.

>ask anaidis about the great scorpius
You can't see any such thing.

* * *

>x anaidis_sitis
You see nothing special about The staring boy.

The boy takes a step back. He radiates a mixture of fear and fascination. "You have spoken about finding water. You will not be successful here."

* * *

>ask anaidis_sitis about no success
Anaidis shakes his head. "I have never said we do not have any water here. Of course we do need water to survive. But we also need to fight for it. That's the reason we're not giving it away easily. Especially not to total strangers.

You are not quite sure how to react to Anaidis statement. He seems to see this. So he starts to smile and mentions "Don't worry - it's less about you. It's more about our history. I know someone who could make you understanding these things. Come with me!"  Anaidis walks west to a huge hut. Follow him!

>west
The Domum Praesidium of Sicuum
As you enter, you see a long table standing in the middle of a spacious room, with a lot of chairs around and kind of executive chair at the tabel's end. So, this huge sandy hut seems to have an official function. During you are still thinking about to whom you are going to speak right now, Anaidis already walks straight ahead into a smaller room. Hurry up! Otherwise you maybe going to lose him.

>straight
That's not a verb I recognise.

>north
Mitéra's Room
You can see Anaidis and Mitéra here.

>x mitéra
You can't see any such thing.

>x mitéra_sitis
Mitéra is a small and wrinkled woman. At the moment she lies on a narrow enhancement out of stone. It seems to be her bed. Anaidis kneels on the ground next to her whispering something incomprehensible. Suddenly, she gets up, actuates you and then her eyes lighten up. 

"Hello stranger! My name is Mitéra, I am the protectress of my loved ones here in Sicuum. Anaidis mentioned you are searching for water. Is that right?"

You nod. It feels like Mitéra is trusting you. She continues.

"You know, Axesto, there was a time, when our village Sicuum and the whole planet Sitis has been a lovely, peaceful and vivid place. Of course - the environment always resembled a desert. But we've had some plants, we've had some animals living here and especially we've had different water sources. These sources have been all around. You never needed to walk a long time until you've found one. But then, there came Scorpius..."

Suddenly you hear loud noises from the Agora. Kids are screaming, parents are calling them concerned and deep male voices are yelling "Out of our way! Out of HIS way!" Anaidis runs shocked out of the room. First, you want to follow him, but then you focuse on Mitéra again. However, she directly signals, you should go after him. So, what are you waiting for?

>s
The Domum Praesidium of Sicuum
Anaidis is outside at the Agora.

>e
The Agora of Sicuum
As you arrive at the Agora, you just wanna know what this Scorpius did. Specially, when you see, how the people are reacting to him. So use your chance, ask Anaidis about.

You can see Anaidis, Machitikos and The Great Scorpius here.

>ask anaidis_sitis about scorpius
Anaidis whispers, "He is a dictator. Earlier, Scorpius was one of us. I mean, the time before I was born. But he was always kind of different. A bit more selfish than other ones, a bit more aggressive and a bit more oppressive. One summer, an aridity befall the whole planet Sitis. We needed to calculate the water more precisely. Consequently, dividing it between everyone and relinquishing, when someone else still got no water, was taken for granted. Except for Scorpius. He refused to share his water and started to manipulate other ones to do the same. This reckless behaviour culminates in his decision to construct an underground system which blocks all of our water sources, so we can not draw on them anymore. The only one that still gave water, was the one in his new built palace, deep in the north. There was and there is no chance to burgle. His guardians are doing their job very well. Since that day, he comes to Siccum every week and forces us to fight for our water. If you win, you will get two full keg of water. If you lose... you have to try to survive one week without new water. And everyone who is trying to steal it or to trick him, is going to prison. Immediately. So. This is the answer you were looking for. When you wanna leave the planet with new water, your only chance is to fight against this warrior Machitikos.

You hesitate few seconds. This gladiator Machitikos looks highly dangerous. He is tall, muscular and his sight is totally aggressive. But you feel determined - you are going to beat him. For yourself and for the repressed Sitisianer. You step directly in front of the great Scorpius.

>x scorpius
You can't see any such thing.

>x scorpius_sitis
You see nothing special about The Great Scorpius.

Scorpius sits on a high wooden throne. "What do you want? You little deformed bastard?!" You answer assertive. 

"I wanna fight. I wanna fight against your bastard Machitikos."

All the people around you start whispering fluttered. Scorpius stares at you incredulous. 

"So... go on. Abortion!

* * *

>x machitikos_sitis
You see nothing special about Machitikos.

Machitikos does not say a word. He just grunts aggressively and throws two weapons in front of you: a long sharp spear and a huge spiked mace. Which one do you take?

>take the spear_sitis
The moment you take the spear, Machitikos begins to attac you with the spiked mace. You definitively underestimated this beast. He strikes you so hard, you do not know how to fight back, then running away towards the desert. Initially!

The Wide Desert
However, you have been faster than Machitikos. That means, you have a bit time to think about, how you could defend yourself against this machine. As you look around, you discover in the east the desert is going downhill. You should go there because deeper in the north there is just adversarial territory.

>e
Rock Mine
You are surrounded by huge grey stones. Too high for you to climb on. But in the east you spot a tree thicket with some old dry trees. They are kind of perfect protection with their knotted treetop. Specially because you are small, light and with long claws - the best premises for climbing.

>e
Tree Thicket
You can see a Rock Mine tree here.

>x you shelter_sitis
You can't see any such thing.

>x shelter tree
You can't see any such thing.

>x rock mine tree_sitis
It's perfect. It's the perfect tree to climb on.

Perfect! It's perfect.

>climb on the rock mine tree_sitis
You can't see any such thing.