Your ship falls through thick layers of dark clouds. Red flashes illuminate your surroundings. The lights on your console warn you of the dangerously fast approaching energy level zero. As you finally break through the last cloud, you get a glimpse of what awaits you underneath. 
Black planes and sharp cliffs of a dark red shape the landscape. In the east you perceive a massive rock formation, in the west you see a thick blue stream cutting through the plane , illuminating big portions of it in the process. Somewhere to the south there seem to be some sort of industrial constructions, far in the north you believe to recognize cubic shapes that reveal a city. You don't have time to study the landscape much longer. All you concentration is desperately needed as you find a gap in the ghastly cliffs and bring down your ship. Heavy jolting, followed by a sudden blow signalize your landing. 
Your ship's on the ground, and you are too, barely. Welcome to Frizza.

On the Lookout
An Interactive Fiction by Daniel, Franziska, Tim, Kevin, Tobias
Release 1 / Serial number 170704 / Inform 7 build 6M62 (I6/v6.33 lib 6/12N) SD

Your arrival point. The Flat Rock
You arrive on a planet called Sitis. You think the landing went great but as you leave your spaceship, you realise that two of your three water container broke down. Without minimum one new watertank you can not continue your journey. Far away in the east you recognise some kind of different rooftops. Maybe someones living there who could help you?

You can see Teleportation Stone - Sitis, Teleportation Stone - Gaisetto, Teleportation Stone - Geysiria, Teleportation Stone - Frizza and Teleportation Stone - Kaldríss here.

>take frizza
Landing Zone
You step out of your ship onto a small square in the middle of nowhere. Your ship's dead and so is the computer. It seems like you ought to explore the environment. You remeber having seen civilization-like shapes to the south-west and to the north. To the east  there is a huge mountain, to the west there seems to be a Flux.

You can see a Discharged Spaceship (empty) here.

>x
What do you want to examine?

>x spaceship
The Discharged Spaceship is empty.

* * *

>take frizza
Landing Zone
You step out of your ship onto a small square in the middle of nowhere. Your ship's dead and so is the computer. It seems like you ought to explore the environment. You remeber having seen civilization-like shapes to the south-west and to the north. To the east  there is a huge mountain, to the west there seems to be a Flux.

You can see a Discharged Spaceship (empty) here.

>e
Ascent
The mountains are composed of stone in various shades of red and reach far to the sky. In between the cliffs and sheers you see a narrow path winding up. There is no clue on where it might lead, but you could find out.

>up
You have the feeling of being watched. You wouldn't want to climb the cliffs if someone is around.

>l
Ascent
The mountains are composed of stone in various shades of red and reach far to the sky. In between the cliffs and sheers you see a narrow path winding up. There is no clue on where it might lead, but you could find out.

You can see Dunia here.

>Ask Dunia about Watching
- You are painfully near to trespass holy ground, stranger. I would advise against it. Who are you, anyway? You don't look like a Techie. Tell me your name.

>Answer Axesto
(to Dunia)
What a strange name. It doesn't matter anyway - there's only one thing I need to know: are you on the side of the Techies or of the Duju?

>Answer Duju
(to Dunia)
- Well then, that's not a bad way to start. Thinking about it - an outsider might be what we need. I'll introduce you to someone, and that is not an invitation.

 With seemingly little effort she climbs down the cliffs to your level, before insistently inviting you to come with her.
 Both of you walk through the scraggy landscape, her leading the way with distinct commands. Slowly you approach an archlike structure, close to one branch of the Flux. As you get nearer you perceive a couple of bulky shapes, guarding the entrance to the structure. Some hundred metes in front of the entrance your companion turns to you. 

- Try not to look too provoking.

You know why while passing the guards: each and every one of them gazes at you. In consideration of the thick armour plates, the rather oversized guns and their radiating blue glow you refrain from making any quick motions.

Flux Gate
You can see a console, a weapon's rack (on which is a gun), Duju Operator 1 and Duju Operator 2 here.

Inside you find yourself in the midst of a small-sized hall, that doesn't appear to justify any of the expenditure you just encountered. In the back you spot an opening and a staircase, leading downwards. To the left there is a full board of controls and two figures unhastily operating them. You can't look around any more, as you are approached quickly by an impressive sized person, already bellowing a few direct words with a booming voice.

 - Dunia! Who is this? Explain yourself!

- A guest of sorts. He stumbled about the Ascent when I found him. I don't think he's a Techie, at least he has a slightly better manners and he keeps his voice down to a sensible level when talking. Besides, I thought about his use in regard to certain issues, due to his undujulike appearance.

Both eyeball you thoroughly for what seems to you like hours. Eventually, the massive Duju makes a quick motion towards Dunia, indicating her to follow him. He shoots a last glance at you.

- Don't let yourself be found sniffing around somewhere, it would not contribute to your wellbeing.

 They march off, disappearing into the opening at the end of the hall. You are not guarded, it seems like you could look around. Of course you could also do as you were told and wait.

>e
Wasteland
A pitiful piece of land. Black sand, red rocks and some sickish looking plants. If you are not looking for something particular there is no need to linger.

>s
Landing Zone
Your crash site. You can go in all directions.

You can see Teleportation Stone - Kaldríss, Teleportation Stone - Frizza, Teleportation Stone - Geysiria, Teleportation Stone - Gaisetto, Teleportation Stone - Sitis and a Discharged Spaceship (empty) here.

>take kaldriíss
You can't see any such thing.

>take kaldríss
Spaceship Bridge
The place where all the magic happens. Well, it used to be at least - during the impact most of the important equpiment including the communication systems must have been fried and doesn't seem to work anymore.  There's only a single flickering light inside the command panel. What could this mean? I should probably open the command panel and take a look. I could also go south and check the storage of the spaceship first.

>l at console
You can't see any such thing.

>l at panel
You see nothing special about the command panel.

I could open this baby up and take a peak inside.

>open command panel
You open the command panel, revealing a protector glove, a fried communicator, a secret storage and a green button.

>open secret storage
It seems to be locked.

>push button#
You can't see any such thing.

>push button
Beep Boop! Secret storage status: OPEN.

>l at starage
You can't see any such thing.

>l at storage
There is a reason this storage compartment is well hidden inside the command panel. Whatever is in there must be of great importance for this spaceship.

>open storage
You open the secret storage, revealing an energy orb and an encryption key.

>take all
Teleportation Stone - Kaldríss: Spaceship Bridge
The place where all the magic happens. Well, it used to be at least - during the impact most of the important equpiment including the communication systems must have been fried and doesn't seem to work anymore.  There's only a single flickering light inside the command panel. What could this mean? I should probably open the command panel and take a look. I could also go south and check the storage of the spaceship first.

You can see Teleportation Stone - Frizza, Teleportation Stone - Geysiria, Teleportation Stone - Gaisetto and Teleportation Stone - Sitis here.

Teleportation Stone - Frizza: Landing Zone
Your crash site. You can go in all directions.

You can see a Discharged Spaceship (empty) here.

(Since something dramatic has happened, your list of commands has been cut short.)

* * *

>open storage
You open the secret storage, revealing an energy orb and an encryption key.

>take orb
I totally forgot that I've put this here. This orb holds a huge amount of energy which could be used to power all kinds of devices and possibly even my suit capacitor.

I really shouldn't be touching the energy orb without something that protects my hand.

>take glove
Taken.

>wear glove
You put on the protector glove.

>take orb
I totally forgot that I've put this here. This orb holds a huge amount of energy which could be used to power all kinds of devices and possibly even my suit capacitor.

This could really work!

Taken.

>l
Spaceship Bridge
The place where all the magic happens. Well, it used to be at least - during the impact most of the important equpiment including the communication systems must have been fried and doesn't seem to work anymore.  There's only a single flickering light inside the command panel. What could this mean? I should probably open the command panel and take a look. I could also go south and check the storage of the spaceship first.

You can see Teleportation Stone - Kaldríss, Teleportation Stone - Frizza, Teleportation Stone - Geysiria, Teleportation Stone - Gaisetto and Teleportation Stone - Sitis here.

* * *

>l
Spaceship Storage
Taking a quick look inside the storage room doesn't seem to reveal anything particularly interesting. There are only some random souvenirs from your previous intergalactic travels and your locker which you haven't opened in ages.  It also looks like the airlock in the south doesn't seem to function anymore so perhaps I should go check that out as well?

>s
Spaceship Exit
The airlock also seems to be affected by the crash and the temperatures inside the spaceship are nearing dangerous levels. I could leave the spaceship right now by going east but I if I don't have something to protect me from the cold I will probably die.

>n
Spaceship Storage
Taking a quick look inside the storage room doesn't seem to reveal anything particularly interesting. There are only some random souvenirs from your previous intergalactic travels and your locker which you haven't opened in ages.  It also looks like the airlock in the south doesn't seem to function anymore so perhaps I should go check that out as well?

>e
You don't want to go there.

>open locker
It seems to be locked.

>unlock locker
What do you want to unlock the locker with?

>i
You are carrying:
  an energy orb
  a protector glove (being worn)
  a backpack (being worn)
  suit capacitor (being worn)

>n
You got caught in a meteor shower and while trying your best to manouver your spaceship through it  your engine still took a hit. You then had to crash-land on Kaldríss - one of the most cold planets in this solar system.  Since only a few explorers made their to this planet there's not a whole lot of information available about this icy place. You are pretty much on your own now. The spaceship also won't take off before it hasn't been properly repaired. But first things first. Without any kind of heat you won't survive this bleakness for long. You tame a look at the command panel in hopes of finding something of use but it doesn't look very good. There's only a single green button on the command panel. What could this mean? I might also wanna  take a look at the spaceship exit that lies straight ahead since it seems to be busted, too.

>l
Spaceship Bridge
The place where all the magic happens. Well, it used to be at least - during the impact most of the important equpiment including the communication systems must have been fried and doesn't seem to work anymore.  There's only a single flickering light inside the command panel. What could this mean? I should probably open the command panel and take a look. I could also go south and check the storage of the spaceship first.

You can see Teleportation Stone - Kaldríss, Teleportation Stone - Frizza, Teleportation Stone - Geysiria, Teleportation Stone - Gaisetto and Teleportation Stone - Sitis here.

>take key
Taken.

>s
Spaceship Storage
Taking a quick look inside the storage room doesn't seem to reveal anything particularly interesting. There are only some random souvenirs from your previous intergalactic travels and your locker which you haven't opened in ages.  It also looks like the airlock in the south doesn't seem to function anymore so perhaps I should go check that out as well?

>unlock locker with key
This key seems to fit.  Lock mechanism status: DEACTIVATED // You may proceed to open the locker.

>open locker
You open the locker, revealing a golden plate and an emergency torch.

>take all
golden plate: Taken.
emergency torch: This baby will light up no matter how harsh the conditions are since it uses a special fuel for the ignition process.

Taken.

>drop plate
Dropped.

>x torch
Plasma Torch Mk. IV - Survival Issue

>s
Spaceship Exit
The airlock also seems to be affected by the crash and the temperatures inside the spaceship are nearing dangerous levels. I could leave the spaceship right now by going east but I if I don't have something to protect me from the cold I will probably die.

>e
Now that you found a way to stay warm you should be able to leave the spaceship without instantly freezing to death.

Crash Zone
The surface of Kaldríss consists of spiky ice formations as far as the eye can see . No wonder nobody in his right mind would try to land here willingly. There doesn't seem to be anything of interest wherever you look. After taking a closer look you suddenly notice some sort of structure north of your position. If you hurry up you should be able to make it there before you freeze.

* * *

>e
Ascent
The mountains are composed of stone in various shades of red and reach far to the sky. In between the cliffs and sheers you see a narrow path winding up. There is no clue on where it might lead, but you could find out.

>u
You have the feeling of being watched. You wouldn't want to climb the cliffs if someone is around.

>x
What do you want to examine?

>i
You are carrying:
  a backpack (being worn)
  suit capacitor (being worn)

>drop backpack
(first taking the backpack off)
Dropped.

>drop capacitor
(first taking suit capacitor off)
Dropped.

>x dunia
A lean but athletic figure, wrapped by several layers of what looks like tough leather. In a small gap of her hood you can see glinting eyes that reveal a sharp mind.

- You are painfully near to trespass holy ground, stranger. I would advise against it. Who are you, anyway? You don't look like a Techie. Tell me your name.

>answer Axesto
(to Dunia)
What a strange name. It doesn't matter anyway - there's only one thing I need to know: are you on the side of the Techies or of the Duju?

>answer Duju
(to Dunia)
- Well then, that's not a bad way to start. Thinking about it - an outsider might be what we need. I'll introduce you to someone, and that is not an invitation.

 With seemingly little effort she climbs down the cliffs to your level, before insistently inviting you to come with her.
 Both of you walk through the scraggy landscape, her leading the way with distinct commands. Slowly you approach an archlike structure, close to one branch of the Flux. As you get nearer you perceive a couple of bulky shapes, guarding the entrance to the structure. Some hundred metes in front of the entrance your companion turns to you. 

- Try not to look too provoking.

You know why while passing the guards: each and every one of them gazes at you. In consideration of the thick armour plates, the rather oversized guns and their radiating blue glow you refrain from making any quick motions.

Flux Gate
You can see a console, a weapon's rack (on which is a gun), Duju Operator 1 and Duju Operator 2 here.

Inside you find yourself in the midst of a small-sized hall, that doesn't appear to justify any of the expenditure you just encountered. In the back you spot an opening and a staircase, leading downwards. To the left there is a full board of controls and two figures unhastily operating them. You can't look around any more, as you are approached quickly by an impressive sized person, already bellowing a few direct words with a booming voice.

 - Dunia! Who is this? Explain yourself!

- A guest of sorts. He stumbled about the Ascent when I found him. I don't think he's a Techie, at least he has a slightly better manners and he keeps his voice down to a sensible level when talking. Besides, I thought about his use in regard to certain issues, due to his undujulike appearance.

Both eyeball you thoroughly for what seems to you like hours. Eventually, the massive Duju makes a quick motion towards Dunia, indicating her to follow him. He shoots a last glance at you.

- Don't let yourself be found sniffing around somewhere, it would not contribute to your wellbeing.

 They march off, disappearing into the opening at the end of the hall. You are not guarded, it seems like you could look around. Of course you could also do as you were told and wait.

>wait
You stand still where you were left. Time passes. However, that seems to be the only thing to change.

>wait
You pass the time looking closer at your surroundings, but you can't interpret all too much from the metallic alien structures. The architecture somewhat reminds you of the spiritual buildings on your home planet, as for the arching walls and the high ceiling. The only thing you hear is the distant, lamish flow of the Flux and the dull sounds of the two operators at the console.

>wait
Finally you see the two Duju returning from the opening. As they approach, the big one actually looks amazed by your decent behaviour.

- It seems like you did as you were told. Maybe you don't have no ill intent after all. Indeed - that is exactly what we're going to find out, if you're willing. But you see, we don't want to force anything on you, you are free to leave. But if you are interested in helping us, we would be glad.

He hands you something that distantly reminds you of a fishing net, only is this one almost ridiculously overengineered. You must have a rather puzzled look to your face, as Du'un starts to explain soon after. 

- That is a Flux Extractor, the Techies call them "Scoops". It is used to extract small portions of the Flux and isolate it for examination. If you want to help us out, showing us that you have no evil intent in the process, go and extract two samples of the Flux, one from the current before it passes through this gate, and one after it has done so. I am sure you will find the proper locations for this purpose yourself. When you are done or have any questions, return here, Dunia will be to your assistance.

You receive a Flux Extractor.

With that, Du'un goes off, quickly descending the stairs at the back of the hall. You are left with a vague task and Dunia, who doesn't look very pleased.

- To your assitance, eh? Well, better than climbing that awful piece of a mountain, I suppose.

>ask dunia about extractor
There is no reply.

>ask dunia about extractor
There is no reply.

>ask dunia about flux extractor
She giggles a bit.

- It is simple, you will see when you get to the Flux. Just dip it in.

She shows a devilish grin. Oh, but there's something I can help you with.

Suddenly Dunia grasps a corner of her leathery clothing and, with one swoosh, unwraps it from her body. Underneath, a sinewy, bluish body comes to appearance.

- Here, take this, it will prevent the Flux from disintegrating you all too fast.

The devilish grin emerges again.

- And stop staring.

You receive a Sinkan Cloak.

>wear cloak
You put on the Sinkan Cloak.

>e
Wasteland
A pitiful piece of land. Black sand, red rocks and some sickish looking plants. If you are not looking for something particular there is no need to linger.

>n
Verge of the Bloo City
An averagely sized city extends in front of you. Its cityscape is dominated by an enormous building in the rear part, not resembling any architecture that you have ever seen. Halfway to it there seems to be some sort of city center. The city is surrounded by a foreign sort of fencing, with a gate not far form you.

>w
Flux beyond the Gate
Another current of the Flux. Even from the distance you feel the pure energy flooding your body. It appears to have a slightly different viscosity than the other Fluxes, maybe it has something to do with the Flux Gate arking above the Flux in the south.

You can see a Regulated Flux Current here.

>approach current
Very cautiously you approach the Flux. While coming nearer, each step feels like pumping pure electrictiy into the ground. Your whole body swings in an unknown rhythm. You are only a few steps away now. The Flux flowing lamishly as ever, blistering, throwing arcs of bluish vapor. You feel your atoms slowly leaving their place, starting to rearrange. You take one step after the other, always expecting that your legs will come apart with the next one. Finally, you reach the pedestal. As you crawl onto it, you feel your mind dissolving, your synapses strewing about. You are becoming the Flux.

>extract
(sample from the Regulated Flux Current)
You thrust your arm over the ledge, despairingly clasping the Flux Extractor, not knowing whether your arm will dematerialize in an instant. The Extractor extends automatically and dips its head into the glowing liquid. You think to hear a beeping sound. It blurs, as your mind dives into the Flux, becomes energy. You perceive magnetic fields, penetrated by some foreign control. You feel the stream, the Flux arranging itself, its symbioses with the planet. You feel the life essence of the Duju, feeding from the Flux. And you feel its core, more powerful than any other source you ever knew, burried deep down in the caverns. Still you have a slim link to your body, but it trembles and shakes heavily. Finally, your hear a tedious, enduring beeping sound. The Flux Extractor is finished, it now carries a sample of the Flux. You force yourself to crawl down the pedestal, your hands feeling like they would disintegrate any moment, their contours growing hazy. With each step you take away from the Flux, your mind and body recover their focus. You drag yourself up the shore and up the cliffs, before collapsing on the rocky soil.

You wake up.

You receive a Regulated Flux Essence.

>e
Verge of the Bloo City
The pathway into the alien city.

>s
Wasteland
One of the dreary planes in the region.

>s
Landing Zone
Your crash site. You can go in all directions.

You can see Teleportation Stone - Kaldríss, Teleportation Stone - Frizza, Teleportation Stone - Geysiria, Teleportation Stone - Gaisetto, Teleportation Stone - Sitis and a Discharged Spaceship (empty) here.

>w
Flux
A viscous current of blue fluid cuts through the plane.  You need to screen your eyes from the radiating light to not become blinded. Even at this distance you feel the Flux" presence in your body, as if your atoms were spinning three times their normal pace. You don't know if it's a good idea to approach it further.

You can see an Unregulated Flux Current here.

>x rock
A huge, slender rock looms at the shore of the Flux. It would make a good land to the Flux. It doesn't seem to stand all too stable, if you could only knock it over with something ...

>e
Landing Zone
Your crash site. You can go in all directions.

You can see Teleportation Stone - Kaldríss, Teleportation Stone - Frizza, Teleportation Stone - Geysiria, Teleportation Stone - Gaisetto, Teleportation Stone - Sitis and a Discharged Spaceship (empty) here.

>nb
That's not a verb I recognise.

>b
That's not a verb I recognise.

>n
Wasteland
One of the dreary planes in the region.

>w
Flux Gate
A gate of some sort, guarded.

You can see Dunia, a console, a weapon's rack (on which is a gun), Duju Operator 1 and Duju Operator 2 here.

>ask dunia about gun
- Ah, I see, you look for a way to get down to the current. Well, the gun is not what will help you, even if I gave it to you, which I won't, you still needed to fire it, which you can't. So erase that thought. However ... what might help you ... wait a moment.

 Dunia turns to the rack, which the gun lies on, and resolutely approaches it. With a few precise movements she breaks loose one of the bars framing the rack, accompanied by a bright clang. Even the guards take a short glance, before respectfully turning to the entrance again. Triumphantly, Dunia returns to you and hands you the bar with a smirk. 

- Congratulations, you are now the owner of a convenient lifting tool.

You receive a Miserable Lever.

>e
Wasteland
One of the dreary planes in the region.

>s
Landing Zone
Your crash site. You can go in all directions.

You can see Teleportation Stone - Kaldríss, Teleportation Stone - Frizza, Teleportation Stone - Geysiria, Teleportation Stone - Gaisetto, Teleportation Stone - Sitis and a Discharged Spaceship (empty) here.

>w
Flux
The main Flux current of the region. A huge rock loosely stands at its shores.

You can see an Unregulated Flux Current here.

>push rock
You thrust the bar into the soil under the rock and start levering. Even with the amplified force you need your whole body to move the rock. Finally, it staggers, and with a last effort you make it topple over. The rock slowly tilts and then continues, with a mighty rumble, to drop into the flux, sending huge waves to both sides. You now have a descent into the Flux. However, your already miserable Lever now is little more than a bent piece of metal, you leave it on the ground

>approach current
With little effort you climb down your newfound ramp. As you come closer to the Flux, you feel your body resonating, feeling as if it would prefer to dissolve. Quickly, you extend the Extractor into the Flux and try to keep your fluttering mind together, while hearing the beeping sound. Shorty, you have visions of a brute Duju, clad in plates of thick metal, thorns protruding from the shoulders. Then a lean figure, wrapped in a long black robe, operating some sort of complex device in front of what seems to you like an altar. A penetrating beeping draws you out of your sight. The Extractor is finished. You scramble up to the shore and quickly bring some distance between you and the Flux, your mind and body slowly regaining their place.

You receive an Unregulated Flux Essence.

>e
Landing Zone
Your crash site. You can go in all directions.

You can see Teleportation Stone - Kaldríss, Teleportation Stone - Frizza, Teleportation Stone - Geysiria, Teleportation Stone - Gaisetto, Teleportation Stone - Sitis and a Discharged Spaceship (empty) here.

>n
Wasteland
One of the dreary planes in the region.

* * *

>w
Flux Gate
A gate of some sort, guarded.

You can see Dunia, a console, a weapon's rack (on which is a gun), Duju Operator 1 and Duju Operator 2 here.

>ask dunia about flux essence
- I see you have the two samples. Impressive ... Wait here for a moment.

She disappears and soon returns with the massive Keeper Du'un. Again you hear the booming of his voice.

- Indeed, he returned. What a cheerful message.

He seems to be smiling, but even this gesture becomes a little intimidating, considering his imposing build.

- Well then, I think you earned an adequate amount of what you could call trust. Let me show you something.

He gently but insistingly points you the way - down the stairs which you have so often seen disappear him in. The opening leads to a rather broad tunnel, lined with blue torches on either side. Curiously but not quite voluntarily you enter the tunnel and proceed to step down the stairs into the darkness, the two Duju right behin you. You descend in silence for a long time . At some point, Dunia briefly raises her voice.

- No one other than our people have seen what you will see. I guess one seeks the aspiring relief of someone not involved on either part after such a long time of disappointment.

Her voice subsides. You hear a soft rumbling from Du'un.

- One might.

The echos of the exchange are the last vocal sounds you hear for quite some time. You continue to pass fairly large holes in the tunnel, revealing peeks into great caves, deep ravines and cascades of Flux. Later - you really couldn't tell how long you walked - the tunnel broadens and finally leads to an opening. The view takes your breath as you step into a vast cavern. You are surrounded by a natural basin, filled to a considerable level with bluish liquid. In the middle of the cave you see a physically impossible spectacle: There, in mid air, a large blue orb is flying, constantly producing waves of fluid, which then drop down into the basin, keeping the lake's surface in motion. You realize that the air is shimmering, despite the cold atmosphere. You gaze at the grand orb, when your vision suddenly becomes grainy and parts of it fold, spawning shadows and bright specks where there should be none. You close your eyes and look to the ground, as you open them again your vision returned to normal. The Keeper raises his voice. 

- Don't let your gaze be caught, or the Flux will consume it. But don't worry, that would have taken a bit longer.

That warning could have come earlier.

You further decend, approaching the big blue lake, when you become aware of a small stone plateau with the stairwell winding around it. Carefully you follow the two Duju down the last steps to the plateau, in the middle of which a small pond of Flux has gathered. Welcome to the core.
Du'un comments your arrival.

- That is the core of our Flux. It is the quintessence. Our very being.

Flux Core.
A huge cavern with a Flux lake at its bottom and a spectacular orb flowing midair, emitting Flux waves. You can't see the tunnel from which you came from. In the middle of the plateau is a small lake, sparkling with a pure sheen.

>ask du'un about essence pool
- You see that Orb there, above? This pool is what it is made of, a special kind of Flux, we call it the Fountain. We will attempt something now. Put both of the Essences in the pool. Start with the Unregulated one.

>put unregulated in pool
(first taking the Unregulated Flux Essence)
You carefully extend the Extractor to drop the sample that you've got from the Flux before the gate into the pool. You hear a muffledsplash. Afterwards, the pool starts swirling, forming thick threads of seemingly solid mass. It encloses the sample in its center and continues to arrange itself in patterns. Finally, with a last compression, it looses the tension and returns to a still state, leaving no sign of the Unregulated Essence. Dunia briefly gives off a comment.

- Now, that was spectacular.

>put regulated in pool
As you drop the Regulated Flux Essence from beyond the gate into the Pool, you hear an impressive silence - the sample actually makes no sound at all as it meets the surface. Excited, you stare at the pool. It shows a rash shiver, a quick swirld, before regaining its calm state. Du'un turns to you, his eyes smiling.

- You might want to know - that is a quite good outcome.

As soon as Du'un finished, the pool again starts to move, first swirling, then seething heavily. The bubbles coming from it become solid in mid-air and drop down again, ghostly arcs of blue smoke emerge from the pool, deep rifts start to form. Unvoluntarily, you take a step back. Just when it seems that the pool would sputter out of its basin the tensions abate, the rifts close and the convulsive motions subside. On turning, you see Du'un holding his staff fixed towards the pool. The last movement goes through the pool, then it falls silent. Suddenly, a small object comes to the surface - a transparent orb with a balanced source of energy inside it: a Pure Flux Orb. 
Du'un points his staff in the direction of the orb and lifts it out of the pool, without touching it, right into a glass container that Dunia stands ready with. As soon as the orb is in the container, Dunia seals it, holding it triumphantly. Du'un turns to you.

- That, now, is something special.

You receive a Pure Flux Essence.

- Oh, and we will need that back.

Dunia takes the Flux Extractor from you, smiling cheekily.

You start the long ascend, Du'un and Dunia following close behind you. Amazed, you hold the Pure Essence in your hands, aware of its worth.

As you finally reach the Flux Gate you see that the operator and staff guards have changed, you must have been down there quite a while. One last time, Du'un adresses you.

- If you insert that into your ship, you should have enough energy for a few thousand years of space travel. Use it wisely. And farewell.

And with that he leaves the Gate, this time heading straight to the north, towards the city.

- I couldn't have said it better. Farewell, and be free to look around, should there be a next time, perhaps I will be there.

Now Dunia too sets out - her in the direction of the ghastly mountains. You stand there, with more energy in your hands than you could ever fathom. It might be time to leave that place.

Flux Gate
A gate of some sort, guarded.

You can see a console, a weapon's rack (on which is a gun), Duju Operator 1 and Duju Operator 2 here.

>e
Wasteland
One of the dreary planes in the region.

* * *

>s
Landing Zone
Your crash site. You can go in all directions.

You can see Teleportation Stone - Kaldríss, Teleportation Stone - Frizza, Teleportation Stone - Geysiria, Teleportation Stone - Gaisetto, Teleportation Stone - Sitis and a Discharged Spaceship (empty) here.

>insert flux essence into spaceship
You put the Essence into the generator of the ship and it instantly starts working - the lights go on, you hear the engine starting and the turbines spinning. Time to take off.

You lift your ship, up and up, until you are far above the surface of Frizza. You take a last glance at the blue Fluxes, the city structures and the rocky landscape, before breaching through the clouds and entering the stratosphere. You did it, you survived Frizza.

For a long time you sail through space, passing moons, asteroids, planets ... you think about your past actions, and of what will come. Before you can help it, you fall to sleep of exhaustion.

Chapter 5 - Kaldriss

You are suddenly woke by heavy jolts and a bursting noise. You quickly orient yourself and grasp the situation. You got caught in a meteor shower and while trying your best to manouver your spaceship through it  your engine still took a hit. You then had to crash-land on Kaldríss - one of the most cold planets in this solar system.  Since only a few explorers made their to this planet there's not a whole lot of information available about this icy place. You are pretty much on your own now. The spaceship also won't take off before it hasn't been properly repaired. But first things first. Without any kind of heat you won't survive this bleakness for long. You tame a look at the command panel in hopes of finding something of use but it doesn't look very good. There's only a single green button on the command panel. What could this mean? I might also wanna  take a look at the spaceship exit that lies straight ahead since it seems to be busted, too.

Spaceship Bridge
The place where all the magic happens. Well, it used to be at least - during the impact most of the important equpiment including the communication systems must have been fried and doesn't seem to work anymore.  There's only a single flickering light inside the command panel. What could this mean? I should probably open the command panel and take a look. I could also go south and check the storage of the spaceship first.

>i
You are carrying:
  a Sinkan Cloak (being worn)

>take all
There are none at all available!

* * *

>n
You got caught in a meteor shower and while trying your best to manouver your spaceship through it  your engine still took a hit. You then had to crash-land on Kaldríss - one of the most cold planets in this solar system.  Since only a few explorers made their to this planet there's not a whole lot of information available about this icy place. You are pretty much on your own now. The spaceship also won't take off before it hasn't been properly repaired. But first things first. Without any kind of heat you won't survive this bleakness for long. You tame a look at the command panel in hopes of finding something of use but it doesn't look very good. There's only a single green button on the command panel. What could this mean? I might also wanna  take a look at the spaceship exit that lies straight ahead since it seems to be busted, too.

>take all
Teleportation Stone - Kaldríss: Spaceship Bridge
The place where all the magic happens. Well, it used to be at least - during the impact most of the important equpiment including the communication systems must have been fried and doesn't seem to work anymore.  There's only a single flickering light inside the command panel. What could this mean? I should probably open the command panel and take a look. I could also go south and check the storage of the spaceship first.

You can see Teleportation Stone - Frizza, Teleportation Stone - Geysiria, Teleportation Stone - Gaisetto and Teleportation Stone - Sitis here.

Teleportation Stone - Frizza: Landing Zone
Your crash site. You can go in all directions.

You can see a Discharged Spaceship (empty) here.

(Since something dramatic has happened, your list of commands has been cut short.)

* * *

>helper
---
 This is the help section, you will get a list of essential commands that you can use in the game.

look - shows you the room you are currently in
 e(x)amine (something)- get information about a thing or a person (if no object or person is specified, something will be examined automatically, if it's the only thing in the room
 take (something) - take and carry something
 (i)nventory - examine what your are carrying

(e)ast - go east
 (w)est - go west
 (s)outh - go south
 (n)orth - go north

save - produce a local save file on your computer
 restore - load a local save file

Frizza
 ask (someone) about (something) - the typical way to begin a dialogue, the topics you can ask about are printed bold in the text beforehand
 answer (something) to (someone) - the typical way to respond to questions, the topics you can answer are printed bold in the text beforehand
 wait - wait some time, some situations may require this
 wear (something) - put clothing on
 take off (something )- take off clothing
 approach (something)-  try to draw closer to an object, some situations may require this
 extract - extract a sample from the Flux Current

Kaldríss
 open/close (something)
 unlock/lock (something)
 insert (something) into (something)
 remove (something) from (something)
 shove (something) aside - some situations with blocked paths may require this
 put (something) on (e.g. clothing)
 follow (someone) - you are able to follow the movement of another character

End of help section
---

* * *

>x myself
Good-looking as ever.